1
0
500 750 0 0
445.618 369.703 -0.191026 0.981585
0
10 10
5 5 5 5 5 0 5 5 5 5 
1 1 1 1 0 0 1 1 1 1 
2 2 2 0 0 0 0 2 2 2 
3 3 0 0 0 0 0 0 3 3 
4 0 0 0 0 0 0 0 0 4 
0 0 0 0 0 0 0 0 0 0 
4 0 0 0 0 0 0 0 0 4 
3 3 0 0 0 0 0 0 3 3 
2 2 2 0 0 0 0 0 2 2 
1 1 1 1 0 0 1 0 0 0 
2
471 357 0 1 1
414 319 0 1 2
