2
1
500 750 0 0
217.365 275.985 -0.826652 -0.562714
0
12 14
0 0 0 0 0 0 0 0 0 0 0 0 0 0 
0 0 0 0 0 0 0 0 0 0 0 0 0 0 
0 0 0 0 0 0 0 0 0 0 0 0 0 0 
0 0 0 0 0 0 0 0 0 2 0 0 0 0 
0 0 0 0 0 0 0 3 0 2 0 2 0 0 
0 0 0 0 0 0 0 3 0 2 0 0 0 0 
0 0 0 0 0 0 0 3 0 0 0 0 0 0 
0 0 2 0 0 0 0 3 0 2 0 0 0 0 
0 0 2 0 0 0 0 3 0 2 0 0 0 0 
0 0 1 1 1 0 1 1 1 1 1 0 0 0 
0 0 1 1 0 1 0 1 1 1 0 0 0 0 
0 0 1 0 0 1 0 0 1 0 0 0 0 0 
8
302 111 0 1 1
97 143 0 1 3
179 175 0 1 0
261 239 0 1 2
